width 16
height 16
data
2 3 4 5 6 7 8 9 9 9 9 9 9 9 9 9
9 0 0 0 0 0 0 0 0 0 0 0 0 0 0 10
9 0 0 0 0 0 0 0 0 0 0 0 0 0 0 9
9 9 9 0 0 9 0 0 0 0 0 0 0 0 0 9
9 9 9 0 0 0 0 0 0 0 0 0 0 0 0 9
9 9 9 0 0 0 0 0 0 0 0 0 0 0 0 9
9 9 9 0 0 9 9 0 0 0 0 0 0 0 0 9
9 9 9 0 0 9 0 0 0 0 0 0 0 0 0 9
9 9 9 0 0 0 0 0 0 0 0 0 0 0 0 9
9 9 9 0 0 0 0 0 0 0 0 0 0 0 0 9
9 9 9 0 0 9 9 0 0 0 0 0 0 0 0 9
9 9 9 0 0 9 0 0 0 0 0 0 0 0 0 9
9 9 9 0 0 9 0 0 0 0 0 0 0 0 0 9
9 9 9 0 0 0 0 0 0 0 0 0 0 0 0 9
9 9 9 0 0 0 0 0 0 0 0 0 0 0 0 9
9 9 9 9 1 1 9 9 9 9 9 9 9 9 9 9